# Syntax Coloring Map For ReGIS
# https://arduino.github.io/arduino-cli/library-specification/#keywords
# Formatted by a single true tab (not spaces)

# Datatypes (KEYWORD1)
offset_t	KEYWORD1
mode_t	KEYWORD1
pattern_t	KEYWORD1
intensity_t	KEYWORD1

# Methods and Functions (KEYWORD2)
window_new	KEYWORD2
window_reset	KEYWORD2
window_write	KEYWORD2
window_clear	KEYWORD2
window_close	KEYWORD2
draw_mode	KEYWORD2
draw_pattern	KEYWORD2
draw_intensity	KEYWORD2
draw_rel	KEYWORD2
draw_ofs	KEYWORD2
draw_abs	KEYWORD2
draw_pixel_rel	KEYWORD2
draw_unpixel_rel	KEYWORD2
draw_pixel_abs KEYWORD2
draw_unpixel_abs	KEYWORD2
draw_line_rel	KEYWORD2
draw_unline_rel	KEYWORD2
draw_line_abs	KEYWORD2
draw_unline_abs	KEYWORD2
draw_box	KEYWORD2
draw_unbox	KEYWORD2
draw_box_fill	KEYWORD2
draw_unbox_fill	KEYWORD2
draw_circle	KEYWORD2
draw_uncircle	KEYWORD2
draw_circle_fill	KEYWORD2
draw_uncircle_fill	KEYWORD2
draw_arc	KEYWORD2
draw_unarc	KEYWORD2
draw_text	KEYWORD2
draw_free	KEYWORD2
unit_v	KEYWORD2
scale_v	KEYWORD2
dot_v	KEYWORD2
mult_v	KEYWORD2
identity_m	KEYWORD2
translate_m	KEYWORD2
scale_m	KEYWORD2
shear_m	KEYWORD2
rotx_m	KEYWORD2
roty_m	KEYWORD2
rotz_m	KEYWORD2
mult_m	KEYWORD2

# Structures (KEYWORD3)
window_t	KEYWORD3
vector_t	KEYWORD3
matrix_t	KEYWORD3

# Constants (LITERAL1)
WIDTH_MAX	LITERAL1
HEIGHT_MAX	LITERAL1

_EE	LITERAL1
_NE	LITERAL1
_NN	LITERAL1
_NW	LITERAL1
_WW	LITERAL1
_SW	LITERAL1
_SS	LITERAL1
_SE	LITERAL1

_REP	LITERAL1
_ERA	LITERAL1
_OVL	LITERAL1
_CPL	LITERAL1

_P0	LITERAL1
_P1	LITERAL1
_P2	LITERAL1
_P3	LITERAL1
_P4	LITERAL1
_P5	LITERAL1
_P6	LITERAL1
_P7	LITERAL1
_P8	LITERAL1
_P9	LITERAL1

_D	LITERAL1
_B	LITERAL1
_R	LITERAL1
_M	LITERAL1
_G	LITERAL1
_C	LITERAL1
_Y	LITERAL1
_W	LITERAL1
